TTTTTTTTTTTTTTTTTTTTTTTTT
T@..F.................TNT
TTTTTTTTTTTTTTTTTTTTT...T
T.F...................T.T
TTTTTT.TTTTTTTTT.TTTTTT.T
T...........T.........T.T
TTTTTTTTTTTTTTTTTTTT.TT.T
T...............T.....T.T
TT.TTTTTTTTTTTTTT.T.TTT.T
T.................T...T.T
TTTTTTTTTTTTT.TTTTTTTTT.T
T...T...........T.T...T.T
T.TTTTTT.TTTTTTTT.TTT.T.T
T...T...........T.T...T.T
TTT...TTTTTTTTT.....TTTFT
T...T.....T.....T.T...GXT
TTTTTTTTTTTTTTTTTTTTTTTTT
