TTTTTTTTTTTTTTTTTTTTTTTTT
T@..F.........T.T......NT
TTTTT.TTTTTTTTT.TTTTTTT.T
T.F.............T.......T
TTTTT.TTTTTTTTTTTTTTTT.TT
T...............T.......T
TTTTTTTT.TTTTTTTTTTTT.T.T
T.....T.....T.T.T.....T.T
TT.TT.TTTT.TT.T...TTTTT.T
T...T.T.....T.T.T.T...T.T
T.TTT.T.T.T.T.T.T.TTT.T.T
T...T...T.T.T.T.T.T.T.T.T
TTTTTTTTTTT...T.T...T.T.T
T.T...T...T.T.T.T.T.T.T.T
T.TTT.TTT.T.T...T.T...TFT
T...........T.T.T.T.T.GXT
TTTTTTTTTTTTTTTTTTTTTTTTT
