#########################
#@#.#.#.....#...#.......#
#.#...#####.###...#####.#
#.#.#.#.........#...#.#.#
#.#.#.##.########.###.#.#
#.#.#...........#.....#.#
#.#.#.#########.###.###.#
#.#.#.#.........#.....#.#
#.#.################.####
#.#.#...........#.#.....#
#...#.#########...###.###
#.#.#.#.........#.......#
#.############.##########
#.#.#...................#
#.#.##################X.#
#...#...................#
#########################
#########################
#.#.......#.....#.......#
#.#.#######.#####.#######
#.......................#
######.################.#
#.........#.........#.#.#
###.###.###.#########.#.#
#.#.#.#...#...........#.#
#...#.#.#.#.#######.#.#.#
#.#...#.#.#.#.......#...#
#.#####.##############.##
#.....#.#.#.........#...#
#.#.###...###.#####.#.###
#.#...#.#.#...#.......#.#
#.#.#####.#.#.##.##.#...#
#.#...#...#.#.#...#.#.#.#
#########################
#########################
#.........#.#.....#.....#
#########...#####...#####
#.........#.#.#...#.#...#
#.#.####.##.#.###.#.#.###
#.#.#.....#.......#.#.#.#
################.##...#.#
#.#.......#.#.....#.#...#
#.#######...#####.#.#.#.#
#.........#.......#.#.#.#
#.#######################
#.........#.........#...#
######.#########.##.##.##
#...........#.....#.#...#
#.###.#####.####.##...#.#
#.#.......#.......#.#.#.#
#########################
#########################
#.............#.#...#...#
########.######.#.###.#.#
#.....#.......#.....#.#.#
##.#########.##.#.#.#.#.#
#...#...#.....#.#.#.#.#.#
###.#.#.#.###...###...#.#
#.....#...#...#.#...#.#.#
#################.###.#.#
#...................#.#.#
###################.#####
#.#.................#...#
#.##############.####.#.#
#.....................#.#
#.#######.###########.###
#.#.................#...#
#########################
#########################
#.#...#.................#
#.##.######.#############
#.#...#...........#...#.#
#.#.###.#########.###.#.#
#...#.#.....#.....#.....#
#.#...###########...#.#.#
#.#.#.............#.#.#.#
#######################.#
#.....#...#.............#
###.####.##.#############
#.....#...#...#.........#
#.#.#.#.#.###.##.########
#.#.#...#.#.#...........#
#.###.#.#.#.#.#.####.####
#.#...#.#.....#.#.......#
#########################
#########################
#.#...#.................#
#.#.#.#.##.##############
#...#...#.......#.#...#.#
##.######.###.###.##.##.#
#...#...#...#...#.......#
#.#.#.#.#######...#######
#.#.#.#.#.......#.....#.#
#.#...#.#.#.###.#.###...#
#.#.#.#.#.#.#...#.#...#.#
#######################.#
#.........#.............#
#.#####.#...###########.#
#.....#.#.#...#.........#
##.####.###############.#
#.....#.#...............#
#########################
#########################
#.................#.....#
#######.########.##.#####
#.........#...........#.#
#.#################.#.#.#
#.................#.#...#
#####.###################
#...#.........#.....#.#.#
###.#########...###.#.#.#
#...........#.#.#.#.....#
#.#########.#.#...###.#.#
#...#.........#.#.#.#.#.#
############.######.#.#.#
#.......#.....#.#.#.#.#.#
#####.######.##.#.#...#.#
#.................#.#.#.#
#########################
#########################
#.#.....#.#...#.#.......#
#.###.###.#.#.#...#######
#.........#.#.#.#.......#
#.##.######.###.#####.###
#.#...........#.#.#.....#
#.###.#########.#.#####.#
#.#.........#.#.#...#...#
#.#########.#...#.#.###.#
#.#...........#.#.#.....#
##########.###########.##
#.............#.........#
########.##.#######.#.###
#.........#...#.#...#...#
###.#########.#.###.#.###
#.........#...#.....#...#
#########################
#########################
#.#.......#.#...#.#.....#
#.#######...#.#.#.#.###.#
#.#.......#.#.#.#...#...#
#...#######.#.#...###.###
#.#.......#...#.#.#.#...#
############.##.#.#.#.#.#
#.............#.#.#.#.#.#
###.#############.#.#.###
#.............#.#.#.#.#.#
#.###########.#.#.#.#.#.#
#...#...........#...#...#
###############.#######.#
#...............#.......#
#.############.########.#
#.......#.......#.......#
#########################
#########################
#...........#.......#...#
#.####.############.#.###
#.#.#.......#.....#.#...#
#.#.#.####.##.#.###.#.#.#
#.#.....#...#.#...#...#.#
#.#.#.###.###.#.#.#.#.#.#
#.#.#.#.#...#.#.#.#.#.#.#
#.#.#.#.#.#.#.#.#.#.#.#.#
#.#.#...#.#.#.#.#...#.#.#
#.#.##############.##.#.#
#.#.........#.......#.#.#
########.#####.##########
#...........#...........#
##.########.######.######
#...#...................#
#########################
#########################
#...............#.#.....#
###########.#####.####.##
#...#...#...#.#.#.#.#...#
#.###.#####.#.#.#.#.#.#.#
#...#...#.#.#...#.#...#.#
###.##.##.#.#.###.#####.#
#.#.#...#.........#.#.#.#
#.#...#...#######...#.#.#
#...#.#.#.......#.#.....#
###################.#####
#.#.............#.#.....#
#.#######.#######.###.###
#...............#...#...#
#.#############...#.##.##
#.#.............#.#.....#
#########################
#########################
#.#.....................#
#...#####################
#.#...#.....#.#.........#
#.#.#...#.#.#.#####.#####
#.#.#.#.#.#.#.#.#.....#.#
#.#####.###.#.#.#.###.#.#
#.#.......#.....#...#...#
#.####.########.###.#.#.#
#.#...........#.....#.#.#
####.####################
#.#.....#...............#
#.#####.##.##############
#.#.....#...............#
#...########.############
#.#.....................#
#########################
#########################
#.......#.#.........#...#
#.####.##.#.###.#####.###
#.#.....#...#...........#
#.##.##.###############.#
#.#...#.#...............#
###.############.########
#...#.#.#.#.........#.#.#
#.#...#.#.#####.###.#.#.#
#.#.#...#.......#.......#
#.#.##.######.######.##.#
#.#.#...........#.....#.#
###.################.##.#
#.#.....#.............#.#
#...##.############.###.#
#.#.#...#.............#.#
#########################
