#########################
#@..........#.....#.#.#.#
########.########...#.#.#
#.#.........#.....#.#.#.#
#.#.###.########.##...#.#
#.#.#...#...#.....#.#...#
#.#.#.#.#.#...#######.###
#...#.#...#.#.......#...#
#################.#######
#.......#.#...........#.#
#######...#.#####.#####.#
#.......#...#.......#.#.#
##########.##.#####.#.#.#
#...........#.....#.....#
#.#######.###.########X.#
#.......#...#...........#
#########################