#########################
#@......................#
###.###.##############.##
#...#.....#.............#
############.############
#.......................#
###.####.##.#.###########
#...#.....#.#...........#
#.#.###.#.#.#.#########.#
#.#.#...#.#.#.#.........#
#.#.##.##.############.##
#.#.#...#.#.#...........#
#.#.#.#.#.#.###########.#
#.#.#.#.#.#.#.......#...#
#.#.#.#.#.#...#####...XN#
#.#.#.#.#.#.#.....#.#.NN#
#########################