TTTTTTTTTTTTTTTTTTTTTTTTT
T@..F.T.T..............NT
T.T.T.T.TT.TTTTTTTTTTTTTT
T.F...T.T.....T.T.T.....T
T.TTTTT.TTTTT...T.T.TTT.T
T.......T.T...T...T.T...T
T.TTTTT.....TTTTT.T.TTTTT
T.....T.T.T...T.........T
TT.TTTTTTTTTTTTTTTTTTTTTT
T.....T.T.T.............T
T.TTTTT.T.TTTTTTTTTTTTT.T
T.........T.............T
TT.TTTTTT.TTTTTTTTTTTT.TT
T.......T.T.......T.....T
T.T.TTT.T...TTTTTTTTT.TFT
T.T...T.T.T...........GXT
TTTTTTTTTTTTTTTTTTTTTTTTT
